{
  "base": {
    "1": { "x": 0, "y": 0 }
  },
  "river_hill": {
    "295": { "x": 6, "y": 0 },
    "296": { "x": 7, "y": 0 },
    "303": { "x": 6, "y": 1 },
    "304": { "x": 7, "y": 1 },
    "310": { "x": 5, "y": 2 },
    "311": { "x": 6, "y": 2 },
    "318": { "x": 5, "y": 3 },
    "325": { "x": 4, "y": 4 },
    
    "75": { "x": 2, "y": 9 },
    "83": { "x": 2, "y": 10 },
    "90": { "x": 1, "y": 11 },
    "91": { "x": 2, "y": 11 },
    "98": { "x": 1, "y": 12 },
    "99": { "x": 2, "y": 12 },
    "106": { "x": 1, "y": 13 },
    "107": { "x": 2, "y": 13 },
    "131": { "x": 2, "y": 16 },
    "139": { "x": 2, "y": 17 },
    "147": { "x": 2, "y": 18 }
  },
  "bridge": {
    "122": { "x": 1, "y": 15 },
    "134": { "x": 5, "y": 16 },
    "268": { "x": 3, "y": 33 },
    "269": { "x": 4, "y": 33 },
    "270": { "x": 5, "y": 33 },
    "276": { "x": 3, "y": 34 },
    "277": { "x": 4, "y": 34 },
    "278": { "x": 5, "y": 34 },
    "284": { "x": 3, "y": 35 },
    "285": { "x": 4, "y": 35 },
    "286": { "x": 5, "y": 35 }
  },
  "biome": {
    "50": { "x": 1, "y": 6 },
    "53": { "x": 4, "y": 6 },
    "392": { "x": 7, "y": 0 },
    "416": { "x": 7, "y": 3 },
    "424": { "x": 7, "y": 4 },
    "457": { "x": 0, "y": 0 },
    "469": { "x": 4, "y": 1 },
    "470": { "x": 5, "y": 1 },
    "471": { "x": 6, "y": 1 },
    "477": { "x": 4, "y": 2 },
    "478": { "x": 5, "y": 2 },
    "479": { "x": 6, "y": 2 },
    "505": { "x": 0, "y": 6 },
    "509": { "x": 4, "y": 6 },
    "510": { "x": 5, "y": 6 },
    "511": { "x": 6, "y": 6 },
    "512": { "x": 7, "y": 6 },
    "518": { "x": 5, "y": 7 },
    "519": { "x": 6, "y": 7 },
    "520": { "x": 7, "y": 7 },
    "525": { "x": 4, "y": 8 },
    "526": { "x": 5, "y": 8 },
    "527": { "x": 6, "y": 8 },
    "528": { "x": 7, "y": 8 }
  },
  "house": {
    "177": { "x": 0, "y": 22 },
    "185": { "x": 0, "y": 23 },
    "187": { "x": 2, "y": 23 },
    "188": { "x": 3, "y": 23 },
    "189": { "x": 4, "y": 23 },
    "237": { "x": 4, "y": 29 },
    "388": { "x": 3, "y": 0 },
    "389": { "x": 4, "y": 0 },
    "390": { "x": 5, "y": 0 },
    "396": { "x": 3, "y": 1 },
    "397": { "x": 4, "y": 1 },
    "398": { "x": 5, "y": 1 },
    "404": { "x": 3, "y": 2 },
    "405": { "x": 4, "y": 2 },
    "406": { "x": 5, "y": 2 },
    "409": { "x": 0, "y": 3 },
    "410": { "x": 1, "y": 3 },
    "411": { "x": 2, "y": 3 },
    "412": { "x": 3, "y": 3 },
    "413": { "x": 4, "y": 3 },
    "414": { "x": 5, "y": 3 },
    "420": { "x": 3, "y": 4 },
    "421": { "x": 4, "y": 4 },
    "422": { "x": 5, "y": 4 },
    "423": { "x": 6, "y": 4 },
    "428": { "x": 3, "y": 5 },
    "429": { "x": 4, "y": 5 },
    "430": { "x": 5, "y": 5 },
    "431": { "x": 6, "y": 5 },
    "436": { "x": 3, "y": 6 },
    "437": { "x": 4, "y": 6 },
    "438": { "x": 5, "y": 6 },
    "439": { "x": 6, "y": 6 },
    "444": { "x": 3, "y": 7 },
    "445": { "x": 4, "y": 7 },
    "446": { "x": 5, "y": 7 },
    "447": { "x": 6, "y": 7 }
  },
  "tree_trunk": {
    "17": { "x": 0, "y": 2 },
    "18": { "x": 1, "y": 2 },
    "19": { "x": 2, "y": 2 },
    "20": { "x": 3, "y": 2 }
  },
  "tree_top": {
    "9": { "x": 0, "y": 1 },
    "10": { "x": 1, "y": 1 },
    "11": { "x": 2, "y": 1 },
    "12": { "x": 3, "y": 1 }
  },
  "bush": {
    "bg": {
      "553": {"x": 1, "y": 0 }
    },
    "fg": {
      "553": {"x": 0, "y": 0 }
    }
  }
}